+-+-+-+-+-+-+-+
|b|  O| | |   |
+ +-+ + + +-+ +
|   |   |     |
+ + + +-+ +-+ +
| |  O|    O| |
+ +-+-+ +-+-+ +
|       |     |
+-+ + +-+-+ +-+
|            c|
+-+-+-+-+-+-+-+